NO ./texture/blue.xpm
SO ./texture/brick.xpm
WE ./texture/grey.xpm
EA ./texture/wood.xpm

F 200,220,0
C 0,0,50

11111111111111111111111111
10000000000000000000000001
10000000000000000000000001
10000000000000000000000001
10000000000001000000000001
10000000000000000000000001
100000000N0000000000000001
10000000000000000000000001
11111111111111111111111111