1111111111111111111111111111111111
1E000000000000000000000C00000C0001
1010010100100000010100100000001011
1010P10010101010001001000000001011
11000000000000000000000C00000C0001
1111111111111111111111111111111111
